S...#.....
##.#.#.###
...#.#...#
.#...###.#
.#.###...#
.#.....#.#
.#####.#.#
.....#...G
